vriend	amigo
vriend	amigo
vriendschap	amizade
Liefde	Amor
dier	animal
middag	tarde
BOOM	ÁRVORE
zilver	prata
kunst	arte
herfst	outono
vliegtuig	avião
luchthaven	aeroporto
banaan	banana
boot	barco
mooi	Legal
bibliotheek	biblioteca
bureau	mesa
bus	ônibus
koffie	café
kaart	cartão
stoel	cadeira
hoed	chapéu
kat	gato
warm	quente
schoenen	sapato
hond	cachorro
lucht	céu
vijf	cinco
toetsenbord	teclado
dans	dança
twee	dois
December	dezembro
water	água
zij	ela
functie	função
onderneming	empresa
familie	família
vrouwen	mulheres
raam	janela
film	filme
bloem	flor
woud	floresta
koud	frio
kaas	queijo
broer	irmão
station	estação
regering	governo
uur	horas
winter	inverno
acht	oito
ziekenhuis	Hospital
hotel	hotel
printer	impressora
tuin	jardim
juli	Julho
juni	Junho
gerechtigheid	justiça
meer	mais
melk	leite
boek	livro
wet	lei
maan	Lua
bril	copos
winkel	loja
huis	casa
wandeling	andar
echtgenoot	marido
ochtend	manhã
zee	mar
minuut	minuto
berg	montanha
horloge	assistir
muziek	música
moeder	mãe
sneeuw	neve
wij	Nós
wolk	nuvem
nacht	noite
vogel	pássaro
oranje	Laranja
computer	computador
brood	pão
broek	par de calças
papier	papel
land	país
zwembad	piscina
strand	praia
regen	chuva
vis	peixe
beleid	política
appel	Maçã
deur	porta
lente	primavera
docent	conferencista
vader	pai
vier	quatro
restaurant	restaurante
rivier	rio
jurk	vestir
Straat	Rua
tas	bolsa
tweede	segundo
zus	irmã
avond	noite
zon	Sol
zon	Sol
muis	rato
sport	esporte
pen	caneta
tafel	mesa
thee	chá
trein	trem
werk	trabalhar
drie	três
telefoon	Telefone
Universiteit	Universidade
dorp	Vila
stad	cidade
auto	carro
reis	viagem
fiets	bicicleta
school	escola
economie	economia
scherm	tela
ster	estrela
student	estudante
zomer	verão
eiland	Ilha
