avond	noche
laat	tarde
Uitgang	salida
aankomst	llegada
antwoord	responder
appel	manzana
apotheek	farmacia
apotheek	farmacia
functie	trabajo
werk	trabajar
arm	brazo
arts	médico
oog	ojo
auto	coche
auto	coche
seizoen	estación
banaan	plátano
bank	banco
boom	árbol
been	pierna
berg	montaña
bibliotheek	biblioteca
bloem	flor
bloed	sangre
bril	gafas
brood	pan
boek	libro
boekwinkel	librería
boekwinkel	librería
bus	autobús
bakkerij	panadería
cafe	cafetería
computer	ordenador
diagnose	diagnóstico
dorp	pueblo
Ingang	entrada
elektronica	electrónica
eten	comer
drijfveer	conducir
bestuurder	conductor
bestuurder	conductora
schema	horario
fiets	bicicleta
fiets	bicicleta
TV	televisor
brandweerlieden	bomberos
vinden	encontrar
vinger	dedo
vis	pez
Sportschool	gimnasio
luchthaven	aeropuerto
vliegtuig	avión
vliegtuig	avión
rivier	río
vragen	preguntar
vriend	amigo
vriend	amiga
vriendschap	amistad
kapper	peluquería
lente	primavera
voet	pie
Galerij	galería
tuin	jardín
bagage	equipaje
gerechtigheid	justicia
wet	ley
gezondheid	salud
hand	mano
een hekel hebben aan	odiar
thuis	casa
bond	piel
herfst	otoño
hart	corazón
Schat	cielo
warmte	calor
broek	pantalones
hotel	hotel
hond	perro
horen	escuchar
vaccin	vacuna
eiland	isla
jaar	año
koffie	café
kalender	calendario
camera	cámara
kaart	tarjeta
kat	gato
kopen	comprar
bioscoop	cine
bioscoop	cine
jurk	vestido
kleren	ropa
bot	hueso
kok	cocinar
koffer	maleta
hoofd	cabeza
cosmetica	cosméticos
ziekenhuis	hospital
verpleegkundige	enfermera
kunst	arte
koud	frío
kaas	queso
loop	correr
voedsel	alimentos
docent	maestro
leren	aprender
lezen	leer
Liefde	amor
Liefde	amar
maag	estómago
markt	mercado
geneesmiddel	medicina
zee	mar
slagerij	carnicería
melk	leche
minuut	minuto
minuut	minuto
middag	mediodía
maand	mes
maan	luna
morgen	mañana
morgen	mañana
mond	boca
museum	museo
museum	museo
muziek	música
meubilair	muebles
laat	tarde
avond	noche
neus	nariz
oor	oído
operatie	operación
oranje	naranja
park	parque
passagier	pasajero
geduldig	paciente
paard	caballo
beleid	política
politie	policía
regen	lluvia
regen	lluvia
regering	gobierno
reis	viaje
reis	viaje
reis	viajar
paspoort	pasaporte
bestemming	destino
restaurant	restaurante
restaurant	restaurante
recept	receta
rugzak	mochila
schip	barco
slaap	dormir
juweliers	joyería
sneeuw	nieve
sneeuw	nieve
schrijven	escribir
schoenen	zapatos
school	escuela
zwembad	piscina
student	estudiante
meer	lago
zien	ver
seconde	segundo
seconde	segundo
zingen	cantar
zomer	verano
zon	sol
zon	sol
geheugen	recuerdo
speelgoed	juguetes
sport	deporte
gesprek	hablar
hop	saltar
stad	ciudad
ster	estrella
pen	bolígrafo
strand	playa
strand	playa
straat	calle
route	ruta
studie	estudiar
uur	hora
storm	tormenta
Supermarkt	supermercado
Supermarkt	supermercado
tablet	pastilla
dag	día
dans	danza
dans	bailar
taxi	taxi
thee	té
telefoon	teléfono
theater	teatro
theater	teatro
behandeling	terapia
ticket	billete
dier	animal
toerist	turista
drinken	beber
klok	reloj
klok	reloj
Universiteit	universidad
accommodatie	alojamiento
onderwijzen	enseñar
vakantie	vacaciones
verkopen	vender
verliezen	perder
Visa	visa
vogel	pájaro
woud	bosque
water	agua
werkplaats	taller
klimaat	clima
wind	viento
winter	invierno
economie	economía
week	semana
live	vivir
wolk	nube
wolk	nube
tandarts	dentista
tijd	tiempo
tijd	tiempo
Dierentuin	zoológico
trein	tren
trein	tren
taal	lengua
