evening	sera
evening	sera
departure	partenza
arrival	arrivo
answer	risposta
apple	mela
pharmacy	farmacia
pharmacy	farmacia
work	lavoro
work	lavoro
poor	povero
physician	medico
eye	occhio
automobile	automobile
automobile	automobile
railroad station	stazione ferroviaria
banana	banana
bank	banca
tree	albero
leg	gamba
mountain	montagna
library	biblioteca
flower	fiore
blood	sangue
glasses	occhiali
bread	pane
book	libro
bookstore	libreria
bookstore	libreria
bus	autobus
bakery	forno
coffee shop	caffetteria
computer	computer
diagnosis	diagnosi
village	villaggio
entrance ticket	biglietto d'ingresso
electronics	elettronica
eat	mangiare
drive	guidare
driver	autista
driver	autista
timetable	orario
bicycle	bicicletta
bicycle	bicicletta
tv	tv
fire department	vigili del fuoco
find	trovare
finger	dito
fish	pescare
gym	palestra
airport	aeroporto
airplane	aereo
airplane	aereo
flow	fluire
questions	domande
friend	amico
girlfriend	fidanzata
friendship	amicizia
barber	barbiere
spring	primavera
foot	piede
gallery	galleria
garden	giardino
baggage	bagaglio
justice	giustizia
law	legge
health	salute
hand	mano
to hate	odiare
house	casa
skin	pelle
autumn	autunno
heart	cuore
heaven	paradiso
heat	calore
trousers	pantaloni
hotel	hotel
dog	cane
hear	ascoltare
vaccination	vaccinazione
island	isola
year	anno
coffee	caffè
calendar	calendario
camera	telecamera
map	carta geografica
cat	gatto
buy	acquistare
movie theater	cinema
movie theater	cinema
dress	vestito
clothing	vestiario
bone	osso
cook	cucinare
suitcase	valigia
head	testa
cosmetics	cosmetici
hospital	ospedale
nurse	infermiera
art	arte
cold	freddo
cheese	formaggio
run	correre
groceries	drogheria
teacher	insegnante
learn	imparare
to read	leggere
love	amore
love	amore
stomach	stomaco
market	mercato
medicine	medicinale
sea	mare
butcher's shop	macelleria
milk	latte
minute	minuto
minute	minuto
midday	mezzogiorno
month	mese
moon	luna
morning	mattina
morning	mattina
mouth	bocca
museum	museo
museum	museo
music	musica
furniture	mobilia
afternoon	pomeriggio
night	notte
nose	naso
ear	orecchio
surgery	chirurgia
orange	arancia
park	parco
passenger	passeggeri
patient	paziente
horse	cavallo
politics	politica
police	polizia stradale
rain	piovere
rain	piovere
government	governo
trip	viaggio
trip	viaggio
travel	viaggio
passport	passaporto
holiday destination	destinazione vacanza
restaurant	ristorante
restaurant	ristorante
recipe	ricetta
backpack	zaino
ship	nave
sleep	sonno
jewelry	gioielleria
snow	nevicare
snow	nevicare
write	scrivere
shoes	scarpe
school	scuola
swimming pool	piscina
pupils	alunni
lake	lago
see	vedere
second	secondo
second	secondo
to sing	cantare
summer	estate
sun	sole
sun	sole
souvenir	souvenir
toy	giocattolo
sports	gli sport
speak	parlare
jump	salto
city	città
star	stella
pen	penna
beach	spiaggia
beach	spiaggia
street	strada
route	itinerario
study	studio
hour	ora
storm	tempesta
supermarket	supermercato
supermarket	supermercato
tablet	tavoletta
day	giorno
dance	danza
dance	danza
taxi	taxi
tea	tè
phone	telefono
theatre	teatro
theatre	teatro
therapy	terapia
ticket	biglietto
animal	animale
tourist	turista
drink	bere
clock	orologio
clock	orologio
university	università
accommodation	alloggio
teach	insegnare
vacation	vacanza
sell	vendere
lose	perdere
visa	visa
bird	uccello
forest	foresta
water	acqua
workshop	officina
weather	tempo atmosferico
wind	vento
winter	inverno
business	attività commerciale
week	settimana
reside	risiedere
cloud	nuvola
cloud	nuvola
dentist	dentista
time	tempo
time	tempo
zoo	zoo
train	treno
train	treno
tongue	lingua