nuit	noite
en retard	tarde
sortie	saída
arrivée	chegada
répondre	responder
pomme	maçã
pharmacie	farmacia
pharmacie	farmacia
emploi	trabalho
travailler	trabalhar
bras	braço
médecin	doutor
œil	olho
voiture	carro
voiture	carro
saison	temporada
banane	banana
banque	banco
arbre	árvore
jambe	perna
montagne	montanha
bibliothèque	biblioteca
fleur	flor
sang	sangue
lunettes	copos
pain	pão
livre	livro
librairie	biblioteca
librairie	biblioteca
bus	ônibus
boulangerie	padaria
café	café
ordinateur	computador
diagnostic	diagnóstico
ville	cidade
entrée	entrada
électronique	eletrônico
manger	comer
conduire	dirigir
conducteur	motorista
conducteur	motorista
calendrier	calendário
vélo	bicicleta
vélo	bicicleta
la télé	televisão
sapeurs pompiers	bombeiros
trouver	encontrar
doigt	dedo
poisson	peixe
salle de sport	academia
aéroport	aeroporto
avion	avião
avion	avião
rivière	rio
demander	perguntar
ami	amigo
amie	amigo
amitié	amizade
salon de coiffure	cabeleireiro
printemps	primavera
pied	pé
galerie	galeria
jardin	jardim
bagage	bagagem
justice	justiça
loi	lei
santé	saúde
main	mão
détester	odiar
maison	casa
fourrure	pelagem
automne	outono
coeur	coração
chéri	querido
chaleur	aquecer
pantalons	calça
hôtel	hotel
chien	cachorro
entendre	ouvir
vaccin	vacina
île	ilha
année	ano
café	café
calendrier	calendário
caméra	câmera
carte	mapa
chat	gato
acheter	comprar
cinéma	cinema
cinéma	cinema
robe	vestir
vêtements	roupas
os	osso
cuisiner	cozinhar
valise	mala
tête	cabeça
produits de beauté	produtos de beleza
hôpital	hospital
infirmière	enfermeira
art	arte
froid	frio
fromage	queijo
courir	correr
nourriture	comida
professeur	professor
apprendre	aprender
lire	ler
amour	amor
amour	amor
estomac	estômago
marché	andar
médecine	medicamento
mer	mar
boucherie	açougue
lait	leite
minute	minuto
minute	minuto
midi	meio-dia
mois	mês
lune	lua
matin	manhã
matin	manhã
bouche	boca
musée	museu
musée	museu
musique	música
meubles	mobília
en retard	tarde
nuit	noite
nez	nariz
oreille	orelha
opération	operação
orange	laranja
parc	parque
passager	passageiro
patient	paciente
cheval	cavalo
politique	política
police	polícia
pluie	chuva
pluie	chuva
gouvernement	governo
voyage	jornada
voyage	jornada
voyager	viajar
passeport	passaporte
destination	destino
restaurant	restaurante
restaurant	restaurante
recette	receita
cartable	mochila
bateau	barco
dormir	dormir
bijoutier	joalheiro
neige	neve
neige	neve
écrire	escrever
chaussures	sapato
école	escola
piscine	piscina
étudiant	estudante
lac	lago
regarder	olhar
deuxième	segundo
deuxième	segundo
chanter	cantar
été	verão
soleil	sol
soleil	sol
souvenir	memória
jouets	brinquedos
sport	esporte
parler	falar
houblon	saltar
ville	cidade
etoile	estrela
stylo	caneta
plage	praia
plage	praia
rue	rua
itinéraire	itinerário
étude	estudar
heure	hora
tempête	tempestade
supermarché	supermercado
supermarché	supermercado
tablette	tábua
jour	dia
danse	dança
danser	dançar
taxi	táxi
thé	chá
téléphone	telefone
théâtre	teatro
théâtre	teatro
thérapie	terapia
billet	bilhete
animal	animal
touristique	passeio turístico
boire	bebida
horloge	relógio
horloge	relógio
l'universitè	a universidade
hébergement	alojamento
enseigner	ensinar
des vacances	feriados
vendre	vender
perdre	perder
visa	visto
oiseau	pássaro
forêt	floresta
eau	água
atelier	oficina
climat	clima
vent	vento
hiver	inverno
économie	economia
semaine	semana
vivre	ao vivo
nuage	nuvem
nuage	nuvem
dentiste	dentista
temps	tempo
temps	tempo
zoo	jardim zoológico
former	forma
former	forma
langue	linguagem