ami	vän
amie	vän
amitié	vänskap
amour	kärlek
animal	djur
après-midi	eftermiddag
arbre	träd
argent	pengar
art	konst
automne	höst
avion	plan
aéroport	flygplats
banane	banan
bateau	båt
beau	skön
bibliothèque	bibliotek
bureau	skrivbord
bus	buss
café	kaffe
carte	karta
chaise	stol
chapeau	hatt
chat	katt
chaud	varm
chaussures	skor
chien	hund
ciel	himmel
cinq	fem
clavier	tangentbord
danse	dansa
deux	två
décembre	december
eau	vatten
elle	hon
emploi	jobb
entreprise	företag
famille	familj
femme	kvinnor
fenêtre	fönster
film	film
fleur	blomma
forêt	skog
froid	kall
fromage	ost
frère	bror
gare	station
gouvernement	regering
heure	timme
hiver	vinter
huit	åtta
hôpital	sjukhus
hôtel	hotell
imprimante	skrivare
jardin	trädgård
juillet	juli
juin	juni
justice	rättvisa
lac	sjö
lait	mjölk
livre	bok
loi	lag
lune	måne
lunettes	glasögon
magasin	lagra
maison	hus
marché	gå
mari	make
matin	morgon
mer	hav
minute	minut
montagne	fjäll
montre	kolla på
musique	musik
mère	mor
neige	snö
nous	vi
nuage	moln
nuit	natt
oiseau	fågel
orange	orange
ordinateur	dator
pain	bröd
pantalon	byxor
papier	papper
pays	land
piscine	slå samman
plage	strand
pluie	regn
poisson	fisk
politique	politik
pomme	äpple
porte	dörr
printemps	vår
professeur	lärare
père	far
quatre	fyra
restaurant	restaurang
rivière	flod
robe	klänning
rue	gata
sac	väska
seconde	andra
soeur	syster
soir	kväll
soleil	sol
soleil	sol
souris	mus
sport	sport
stylo	penna
table	tabell
thé	te
train	tåg
travail	arbete
trois	tre
téléphone	telefon
université	universitet
village	by
ville	stad
voiture	bil
voyage	resa
vélo	cykel
école	skola
économie	ekonomi
écran	skärm
étoile	stjärna
étudiant	studerande
été	sommar
île	ö