April	April
August	August
Dezember	December
Februar	Debruary
Januar	January
Juli	July
Juni	June
Marsch	March
Mai	May
November	November
Oktober	October
September	September
Wut	fury
Apfel	apple
Banane	banana
Schlafzimmer	bedroom
Bier	beer
Fahrrad	bicycle
Vogel	bird
Schwarz	black
Blau	blue
Boot	boat
Buch	book
Bremse	brake
brot	bread
Bruder	brother
braun	brown
Bus	bus
Auto	automobile
Katze	cat
Käse	cheese
Huhn	chicken
Kaffee	coffee
Computer	computer
Tochter	daughter
Hund	dog
Tür	door
runter	down
Ost	east
Ei	egg
acht	eight
achtzehn	eighteen
elf	eleven
Motor	engine
Vater	father
Furcht	fear
fünfzehn	fifteen
Fisch	fish
fünf	five
Boden	floor
Blume	flower
Essen	eat
vier	four
vierzehn	fourteen
Freundschaft	friendship
Garten	garden
Großvater	grandfather
Oma	granny
Grün	green
Glück	luck
Er	he
Hoffnung	hope
Haus	house
Eifersucht	jealousy
Küche	kitchen
links	left
Wohnzimmer	living room
Liebe	love
Fleisch	meat
Milch	milk
Mutter	mother
Motorrad	motorcycle
neun	nine
neunzehn	nineteen
Norden	north
eins	one
Stift	pen
Telefon	phone
Rosa	pink
Flugzeug	airplane
Stolz	proud
lila	purple
Rot	red
Reis	rice
Rechts	right
Dach	roof
Zimmer	room
Traurigkeit	sadness
Salz	salt
Sieben	seven
siebzehn	seventeen
sie	she
Schwester	sister
sechs	six
sechzehn	sixteen
Sohn	son
Süd	south
Zucker	sugar
Tee	tea
zehn	ten
dreizehn	thirteen
drei	three
Baum	tree
zwölf	twelve
zwanzig	twenty
zwei	two
hoch	high
Wand	wall
Wasser	water
Wir	we
Westen	west
Rad	wheel
Weiß	white
Fenster	window
Wein	wine
Gelb	yellow