sera	noche
tardi	tarde
uscita	salida
arrivo	llegada
rispondere	responder
mela	manzana
farmacia	farmacia
farmacia	farmacia
lavoro	trabajo
lavoro	trabajar
braccio	brazo
medico	médico
occhio	ojo
auto	coche
auto	coche
stagione	estación
banana	plátano
banca	banco
albero	árbol
gamba	pierna
montagna	montaña
biblioteca	biblioteca
fiore	flor
sangue	sangre
occhiali	gafas
pane	pan
libro	libro
libreria	librería
libreria	librería
autobus	autobús
forno	panadería
bar	cafetería
computer	ordenador
diagnosi	diagnóstico
città	pueblo
entrata	entrada
elettronica	electrónica
mangiare	comer
guidare	conducir
autista	conductor
autista	conductora
programma	horario
bicicletta	bicicleta
bicicletta	bicicleta
tv	televisor
vigili del fuoco	bomberos
trovare	encontrar
dito	dedo
pescare	pez
palestra	gimnasio
aeroporto	aeropuerto
aereo	avión
aereo	avión
fiume	río
chiedere	preguntar
amico	amigo
amico	amiga
amicizia	amistad
parrucchiere	peluquería
primavera	primavera
piede	pie
galleria	galería
giardino	jardín
bagaglio	equipaje
giustizia	justicia
legge	ley
salute	salud
mano	mano
odio	odiar
casa	casa
pelliccia	piel
autunno	otoño
cuore	corazón
tesoro	cielo
calore	calor
pantaloni	pantalones
hotel	hotel
cane	perro
ascoltare	escuchar
vaccino	vacuna
isola	isla
anno	año
caffè	café
calendario	calendario
telecamera	cámara
carta	tarjeta
gatto	gato
acquistare	comprar
cinema	cine
cinema	cine
vestito	vestido
vestiti	ropa
osso	hueso
cucinare	cocinar
valigia	maleta
testa	cabeza
cosmetici	cosméticos
ospedale	hospital
infermiera	enfermera
arte	arte
freddo	frío
formaggio	queso
correre	correr
cibo	alimentos
insegnante	maestro
imparare	aprender
leggere	leer
amore	amor
amore	amar
stomaco	estómago
mercato	mercado
medicinale	medicina
mare	mar
macelleria	carnicería
latte	leche
minuto	minuto
minuto	minuto
mezzogiorno	mediodía
mese	mes
luna	luna
domani	mañana
domani	mañana
bocca	boca
museo	museo
museo	museo
musica	música
mobilia	muebles
tardi	tarde
sera	noche
naso	nariz
orecchio	oído
operazione	operación
arancia	naranja
parco	parque
passeggeri	pasajero
paziente	paciente
cavallo	caballo
politica	política
polizia stradale	policía
piovere	lluvia
piovere	lluvia
governo	gobierno
viaggio	viaje
viaggio	viaje
viaggio	viajar
passaporto	pasaporte
destinazione	destino
ristorante	restaurante
ristorante	restaurante
ricetta	receta
zaino	mochila
nave	barco
sonno	dormir
gioielliere	joyería
nevicare	nieve
nevicare	nieve
scrivere	escribir
scarpe	zapatos
scuola	escuela
piscina	piscina
alunno	estudiante
lago	lago
vedere	ver
secondo	segundo
secondo	segundo
cantare	cantar
estate	verano
sole	sol
sole	sol
memoria	recuerdo
giocattoli	juguetes
sport	deporte
parlare	hablar
salto	saltar
città	ciudad
stella	estrella
penna	bolígrafo
spiaggia	playa
spiaggia	playa
strada	calle
itinerario	ruta
studio	estudiar
ora	hora
tempesta	tormenta
supermercato	supermercado
supermercato	supermercado
tavoletta	pastilla
giorno	día
danza	danza
danza	bailar
taxi	taxi
tè	té
telefono	teléfono
teatro	teatro
teatro	teatro
terapia	terapia
biglietto	billete
animale	animal
turista	turista
bere	beber
orologio	reloj
orologio	reloj
università	universidad
alloggio	alojamiento
insegnare	enseñar
vacanza	vacaciones
vendere	vender
perdere	perder
visa	visa
uccello	pájaro
foresta	bosque
acqua	agua
officina	taller
clima	clima
vento	viento
inverno	invierno
economia	economía
settimana	semana
vivere	vivir
nuvola	nube
nuvola	nube
dentista	dentista
tempo	tiempo
tempo	tiempo
zoo	zoológico
treno	tren
treno	tren
lingua	lengua