noite	Abend
noite	Abend
partida	Abfahrt
chegada	Ankunft
responder	Antworten
maçã	Apfel
farmacia	Apotheke
farmacia	Apotheke
trabalhar	Arbeit
trabalhar	Arbeiten
pobre	Arm
médico	Arzt
olho	Auge
automóvel	Auto
automóvel	Auto
estação ferroviária	Bahnhof
banana	Banane
banco	Bank
árvore	Baum
perna	Bein
montanha	Berg
biblioteca	Bibliothek
flor	Blume
sangue	Blut
copos	Brille
pão	Brot
livro	Buch
livraria	Buchhandlung
livraria	Buchhandlung
ônibus	Bus
padaria	Bäckerei
cafeteria	Café
computador	Computer
diagnóstico	Diagnose
vila	Dorf
bilhete de entrada	Eintrittskarte
eletrônicos	Elektronik
comer	Essen
dirigir	Fahren
motorista	Fahrer
motorista	Fahrerin
calendário	Fahrplan
bicicleta	Fahrrad
bicicleta	Fahrrad
televisão	Fernseher
corpo de bombeiros	Feuerwehr
encontrar	Finden
dedo	Finger
peixe	Fisch
academia	Fitnessstudio
aeroporto	Flughafen
avião	Flugzeug
avião	Flugzeug
fluxo	Fluss
questões	Fragen
amigo	Freund
namorada	Freundin
amizade	Freundschaft
barbeiro	Friseur
primavera	Frühling
pé	Fuß
galeria	Galerie
jardim	Garten
bagagem	Gepäck
justiça	Gerechtigkeit
lei	Gesetz
saúde	Gesundheit
mão	Hand
odiar	Hassen
casa	Haus
pele	Haut
outono	Herbst
coração	Herz
paraíso	Himmel
aquecer	Hitze
calça	Hose
hotel	Hotel
cachorro	Hund
ouvir	Hören
vacinação	Impfung
ilha	Insel
ano	Jahr
café	Kaffee
calendário	Kalender
câmera	Kamera
mapa	Karte
gato	Katze
comprar	Kaufen
cinema	Kino
cinema	Kino
vestir	Kleid
roupas	Kleidung
osso	Knochen
cozinhar	Kochen
mala	Koffer
cabeça	Kopf
cosméticos	Kosmetik
hospital	Krankenhaus
enfermeira	Krankenschwester
arte	Kunst
frio	Kälte
queijo	Käse
correr	Laufen
mantimentos	Lebensmittel
professor	Lehrer
aprender	Lernen
ler	Lesen
amor	Liebe
amor	Lieben
estômago	Magen
mercado	Markt
medicamento	Medizin
mar	Meer
açougue	Metzgerei
leite	Milch
minuto	Minute
minuto	Minute
meio-dia	Mittag
mês	Monat
lua	Mond
manhã	Morgen
manhã	Morgen
boca	Mund
museu	Museum
museu	Museum
música	Musik
mobília	Möbel
tarde	Nachmittag
noite	Nacht
nariz	Nase
orelha	Ohr
cirurgia	Operation
laranja	Orange
parque	Park
passageiro	Passagier
paciente	Patient
cavalo	Pferd
política	Politik
polícia	Polizei
chuva	Regen
chuva	Regen
governo	Regierung
viagem	Reise
viagem	Reise
viagem	Reisen
passaporte	Reisepass
destino de férias	Reiseziel
restaurante	Restaurant
restaurante	Restaurant
receita	Rezept
mochila	Rucksack
enviar	Schiff
dormir	Schlafen
joia	Schmuck
neve	Schnee
neve	Schnee
escrever	Schreiben
sapato	Schuhe
escola	Schule
piscina	Schwimmbad
alunos	Schüler
lago	See
ver	Sehen
segundo	Sekunde
segundo	Sekunde
cantar	Singen
verão	Sommer
sol	Sonne
sol	Sonne
lembrança	Souvenir
brinquedo	Spielzeug
esportes	Sport
falar	Sprechen
pular	Springen
cidade	Stadt
estrela	Stern
caneta	Stift
praia	Strand
praia	Strand
rua	Straße
rota	Strecke
estudar	Studieren
hora	Stunde
tempestade	Sturm
supermercado	Supermarkt
supermercado	Supermarkt
tábua	Tablette
dia	Tag
dança	Tanz
dança	Tanzen
táxi	Taxi
chá	Tee
telefone	Telefon
teatro	Theater
teatro	Theater
terapia	Therapie
bilhete	Ticket
animal	Tier
turista	Tourist
bebida	Trinken
relógio	Uhr
relógio	Uhr
universidade	Universität
alojamento	Unterkunft
ensinar	Unterrichten
férias	Urlaub
vender	Verkaufen
perder	Verlieren
visto	Visum
pássaro	Vogel
floresta	Wald
água	Wasser
oficina	Werkstatt
clima	Wetter
vento	Wind
inverno	Winter
negócios	Wirtschaft
semana	Woche
residir	Wohnen
nuvem	Wolke
nuvem	Wolke
dentista	Zahnarzt
tempo	Zeit
tempo	Zeit
jardim zoológico	Zoo
trem	Zug
trem	Zug
língua	Zunge