compra	compra
amigo	amigo
amiga	amigo
año	ano
agosto	agosto
tarde	tarde
dinero	dinheiro
artefacto	artefato
astronomía	astronomia
avión	avião
aeropuerto	aeroporto
plátano	banana
banco	banco
barco	enviar
biblioteca	biblioteca
biología	biologia
autobús	ônibus
café	café
cien	centenas
silla	cadeira
gato	gato
perro	cachorro
química	química
cinco	cinco
cincuenta	cinquenta
cine	cinema
teclado	teclado
cliente	cliente
habilidad	habilidade
contrato	contrato
delito	crime
cultura	cultura
danza	dança
dos	dois
diez	dez
dieciocho	dezoito
diecinueve	dezenove
diecisiete	dezessete
doce	doze
diciembre	dezembro
agua	água
ella	ela
empresa	empresa
exposición	exposição
factura	fatura
ventana	janela
flor	flor
formación	treinamento
bosque	floresta
fraternidad	fraternidade
queso	queijo
fruta	fruta
hermano	irmão
galería	galeria
estación	estação
gobierno	governo
hora	hora
historia	história
ocho	oito
hospital	hospital
hospital	hospital
hotel	hotel
impresora	impressora
día	dia
julio	julho
junio	junho
justicia	justiça
lago	lago
leche	leite
libertad	liberdade
libro	livro
libro	livro
ley	lei
ocio	lazer
luna	lua
verduras	vegetais
tienda	loja
casa	lar
mercado	mercado
matemáticas	matemática
mañana	manhã
mar	mar
mil	mil
minuto	minuto
montaña	montanha
música	música
museo	museu
madre	mãe
médico	doutor
medicamento	medicamento
nieve	neve
nueve	nove
nosotros	nós
noviembre	novembro
nube	nuvem
noche	noite
octubre	outubro
once	onze
naranja	laranja
ordenador	computador
pan	pão
papel	papel
pintura	pintar
farmacia	farmacia
filosofía	filosofia
fotografía	fotografia
física	físico
piscina	piscina
playa	praia
lluvia	chuva
pescado	peixe
policía	polícia
política	política
manzana	maçã
puerta	porta
pollo	frango
cárcel	cadeia
psicología	psicologia
padre	pai
cuarenta	quarenta
catorce	quatorze
cuatro	quatro
noventa	noventa
ochenta	oitenta
quince	quinze
religión	religião
restaurante	restaurante
río	rio
reserva	reserva
reunión	reunião
éxito	sucesso
ensalada	salada
sueldo	salário
salud	saúde
ciencia	ciência
escultura	escultura
segundo	segundo
dieciséis	dezesseis
siete	sete
septiembre	setembro
seis	seis
noche	noite
sesenta	sessenta
setenta	setenta
sol	sol
ratón	rato
deporte	esporte
bolígrafo	caneta
hermana	irmã
mesa	mesa
tiempo	tempo
té	chá
boleto	bilhete
turismo	turismo
tradición	tradição
tren	trem
trabajo	trabalho
trece	treze
treinta	trinta
tres	três
teléfono	telefone
vacaciones	férias
viento	vento
venta	oferta
carne	carne
pueblo	cidade
ciudad	cidade
veinte	vinte
coche	carro
voto	voto
vosotros	você
viaje	jornada
bicicleta	bicicleta
fracaso	falha
escuela	escola
pantalla	tela
igualdad	igualdade
elección	escolha
equipo	equipamento
estrella	estrela