noche	evening
tarde	late
salida	exit
llegada	arrival
responder	reply
manzana	apple
farmacia	pharmacy
farmacia	pharmacy
trabajo	job
trabajar	work
brazo	arm
médico	doctor
ojo	eye
coche	car
coche	car
estación	season
plátano	banana
banco	bank
árbol	tree
pierna	leg
montaña	mountain
biblioteca	library
flor	flower
sangre	blood
gafas	glasses
pan	bread
libro	book
librería	bookshop
librería	bookshop
autobús	bus
panadería	bakery
cafetería	café
ordenador	computer
diagnóstico	diagnosis
pueblo	town
entrada	entrance
electrónica	electronics
comer	eat
conducir	drive
conductor	driver
conductora	driver
horario	schedule
bicicleta	bicycle
bicicleta	bicycle
televisor	tv
bomberos	firefighters
encontrar	find
dedo	finger
pez	fish
gimnasio	gym
aeropuerto	airport
avión	plane
avión	plane
río	river
preguntar	ask
amigo	friend
amiga	friend
amistad	friendship
peluquería	hair salon
primavera	spring
pie	foot
galería	gallery
jardín	garden
equipaje	luggage
justicia	justice
ley	law
salud	health
mano	hand
odiar	hate
casa	home
piel	fur
otoño	autumn
corazón	heart
cielo	darling
calor	heat
pantalones	pants
hotel	hotel
perro	dog
escuchar	hear
vacuna	vaccine
isla	island
año	year
café	coffee
calendario	calendar
cámara	camera
tarjeta	card
gato	cat
comprar	buy
cine	cinema
cine	cinema
vestido	dress
ropa	clothes
hueso	bone
cocinar	cook
maleta	suitcase
cabeza	head
cosméticos	cosmetics
hospital	hospital
enfermera	nurse
arte	art
frío	cold
queso	cheese
correr	run
alimentos	food
maestro	teacher
aprender	learn
leer	read
amor	love
amar	love
estómago	stomach
mercado	market
medicina	medicine
mar	sea
carnicería	butcher shop
leche	milk
minuto	minute
minuto	minute
mediodía	noon
mes	month
luna	moon
mañana	tomorrow
mañana	tomorrow
boca	mouth
museo	museum
museo	museum
música	music
muebles	furniture
tarde	late
noche	evening
nariz	nose
oído	ear
operación	operation
naranja	orange
parque	park
pasajero	passenger
paciente	patient
caballo	horse
política	policy
policía	police
lluvia	rain
lluvia	rain
gobierno	government
viaje	journey
viaje	journey
viajar	travel
pasaporte	passport
destino	destination
restaurante	restaurant
restaurante	restaurant
receta	recipe
mochila	backpack
barco	ship
dormir	sleep
joyería	jeweler's
nieve	snow
nieve	snow
escribir	write
zapatos	shoes
escuela	school
piscina	pool
estudiante	student
lago	lake
ver	see
segundo	second
segundo	second
cantar	sing
verano	summer
sol	sun
sol	sun
recuerdo	memory
juguetes	toys
deporte	sport
hablar	talk
saltar	hop
ciudad	city
estrella	star
bolígrafo	pen
playa	beach
playa	beach
calle	street
ruta	route
estudiar	study
hora	hour
tormenta	storm
supermercado	supermarket
supermercado	supermarket
pastilla	tablet
día	day
danza	dance
bailar	dance
taxi	cab
té	tea
teléfono	phone
teatro	theater
teatro	theater
terapia	therapy
billete	ticket
animal	animal
turista	tourist
beber	to drink
reloj	clock
reloj	clock
universidad	university
alojamiento	accommodation
enseñar	teach
vacaciones	vacation
vender	sell
perder	lose
visa	visa
pájaro	bird
bosque	forest
agua	water
taller	workshop
clima	climate
viento	wind
invierno	winter
economía	economy
semana	week
vivir	live
nube	cloud
nube	cloud
dentista	dentist
tiempo	time
tiempo	time
zoológico	zoo
tren	train
tren	train
lengua	language